W,W,W,W,W,W,W,W,W,W,W,W,W,W,W,W,W,W,W,W,W,W,W,W,W,W,W,W,W,W,W,W,W,W,W,W,W,W,W,W
W,E,E,E,E,E,E,E,E,E,E,E,E,E,E,E,E,E,E,E,E,E,E,E,E,E,E,E,E,E,E,E,E,E,E,E,E,E,E,W
W,E,E,E,E,E,E,E,E,E,E,E,E,E,E,E,E,E,E,E,E,E,E,E,E,E,E,E,E,E,E,E,E,E,E,E,E,E,E,W
W,E,E,E,E,E,E,E,E,E,E,E,E,E,E,E,E,E,E,E,E,E,E,E,E,E,E,E,E,E,E,E,E,E,E,E,E,E,E,W
W,E,E,E,E,E,E,E,E,E,E,E,E,E,E,E,E,E,E,E,E,E,E,E,E,E,E,E,E,E,E,E,E,E,E,E,E,E,E,W
W,E,E,E,E,E,E,E,E,E,E,E,E,E,E,E,E,E,E,E,E,E,E,E,E,E,E,E,E,E,E,E,E,E,E,E,E,E,E,W
W,E,E,E,E,E,E,E,E,E,E,E,E,E,E,E,E,E,E,LU,E,E,E,E,E,E,E,E,E,LM,E,E,E,E,E,E,E,E,E,W
W,E,E,E,E,E,E,E,E,E,E,E,W,W,W,E,E,E,E,W,W,W,E,E,E,E,E,E,E,W,W,W,E,E,E,E,E,E,E,E,W
W,E,E,E,E,E,E,E,LJ,E,E,E,E,E,E,E,E,E,E,E,E,E,E,E,E,E,E,E,E,E,E,E,E,E,E,E,E,E,E,W
W,E,E,E,E,E,E,W,W,W,E,E,E,E,E,E,E,E,E,E,E,E,E,E,E,E,E,E,E,E,E,E,E,E,E,E,E,E,E,W
W,E,E,E,E,E,E,E,E,E,E,E,E,E,E,E,E,E,E,E,E,E,E,E,E,E,E,W,W,W,W,E,E,E,E,E,E,E,E,W
W,E,E,ES,LP,E,E,E,E,E,E,E,E,E,E,E,E,E,E,E,E,E,E,E,E,E,E,E,E,E,E,E,E,E,E,E,E,E,E,W
W,E,W,W,W,W,W,E,E,E,E,E,E,E,E,E,E,E,E,E,E,E,E,E,E,E,E,E,E,E,E,E,E,E,E,E,E,E,E,W
W,E,E,E,E,E,E,E,E,E,E,E,E,E,E,E,E,E,E,E,E,E,E,E,E,E,E,E,E,E,E,E,E,E,E,E,E,E,E,W
W,E,E,E,E,E,E,E,E,E,E,E,E,E,E,E,E,E,E,E,E,E,E,E,E,E,E,E,E,E,E,E,E,E,E,E,E,E,E,W
W,E,E,E,E,E,E,E,E,E,E,W,W,E,E,E,E,E,E,E,E,E,E,E,E,E,E,E,E,E,E,E,E,E,E,E,E,E,E,W
W,E,E,E,E,E,E,E,E,E,E,E,E,E,E,E,E,E,E,E,E,E,E,E,E,E,E,E,E,E,E,E,E,E,E,E,E,E,E,W
W,E,E,E,E,E,E,E,E,E,E,E,E,E,E,E,LF,E,E,E,E,E,E,E,E,E,E,E,E,E,E,E,E,E,ES,E,E,E,E,W
W,E,E,E,E,E,E,E,E,E,E,LL,,E,E,E,W,W,W,E,E,E,E,E,E,E,E,E,E,E,E,E,E,W,W,W,E,E,E,W
W,E,E,E,E,E,LI,E,E,E,W,W,W,E,E,E,,E,E,E,E,E,E,E,E,E,E,E,E,E,LE,E,E,E,E,E,E,E,E,W
W,E,E,E,E,W,W,W,E,E,E,E,E,E,E,E,E,E,E,E,E,E,E,E,E,E,E,E,E,W,W,W,E,E,E,E,E,E,E,W
W,E,E,E,E,E,E,E,E,E,E,E,E,E,E,E,E,E,E,E,E,E,E,E,E,E,E,E,E,E,E,E,E,E,E,E,E,E,E,W
W,ST,E,E,E,E,E,E,E,E,E,E,E,E,E,E,E,E,E,E,E,E,E,E,E,E,E,E,E,E,E,E,E,E,E,E,E,E,EN,W
W,W,W,W,W,W,W,W,W,W,W,W,W,W,W,W,W,W,W,W,W,W,W,W,W,W,W,W,W,W,W,W,W,W,W,W,W,W,W,W